000000000000000000000000000000000000000000000000000000000000000000000000000000000000000000000000000000000000000000000000000000000000000000000000MMMMMMMMMMMM00000000000000000000000000000000000000000000000000000000000000000000000000000000000000000000000000000MMMMMMMMMMMMMMMMMMMMMMMMM000000000000000000000000000000000000000000000000000000000000000000000000000000000000000000000000000000000000000000000000000000000M000000000000000000000MMMMMMMMMM000000000MMMMMMMMMMMMMM000000000000000000000000000000000000000000000000000000000000000000000000000000000000000000000000000000000000000000000000000000000000000000000000000000000000000000000000000000000000000000000000000000000000000000000000000000000000000000000000000000000000000000000000000000000000000000000000000000000000000000000000000000000000000000000000000000000000000000000000000000000000000000000000000000000000000000000000000000000000000000000000000000000000000000000000000000000000000000000000000000000000000000000000000000000000000000000000000000
000000000000000000000000000000000000000000000000000000000000000000000000000000000000000000000000000MMMMMMM00000000000000000000000000000000000000MMMMMMMMMMMW000MMMM00000000000000000000000000000000000000000000000000000000000000000000000000000000000000000000000MMMMMMMMMMMM0000000MMMMMM000000000000000000000000000000000000000000000000000000000000000000000000000000000000000000000000MMMMMMMMMMM000000000000000000000W00M00000000000000000000MMMMMM000000000000MMMMMMMMMMM00000000000000000000000000000000000000000000000000000000000000000000000000000000000000000000000000000000000000000000000000000000000000000000000000000000000000000000000000000000000000000000000000000000000000000000000000000000000000000000000000000000000000000000000000000000000000000000000000000000000000000000000000000000000000000000000000000000000000000000000000000000000000000000000000000000000000000000000000000000000000000000000000000000000000000000000000000000000000000000000000000000000000000000000000000000000000000000000000000000
MMMMMMMMM000000000000000000000000000000000000000000000000000000000000000000000000000000000000000000000000000000000000000MMMM0000000000000000000000MMMMMMMMMM000MMMM0000000000000000000000000000000MMMM00000000000000000000000000000000000000000000000000000000000000MMMMMMM0000000000MMMMMM000000000000000000000000000000000000000000000000000000000000000000000000MM0000000MM0000M000000000000000MMMMMMMMMMMM000MMMMM00000M00M00000000000000000000MMMM00000000000000MMMMMMMMM0000000000000000000000000000000000000WMMM0000000000000MM0M0M00M0000000000000000000000000000000000000000000000000000000000000000000000000000000000000000000000000000000000000000000000000000000000000000000000000000000000000000000000000000000000000000000000000000000000000000000000000000000000000000000000000000000000000000000000000000000000000000000000000000000000000000000000000000000000000000000000000000000000000000000000000000000000000000000000000000000000000000000000000000000000000000000000000000000000000000000000000000000000000000000
M000MMM000000000000000000000000000000000000000000000000000000000000000000000000000000000000000000000000000000MM0000000000000000MMM0000000000000000MMMMM00000000MMMM00000000000000000000000000000000MMMM000000000000000000000000000000000000000000000000000000000000000000000000000000MMMMMMM0000000000000000000000000000000000000000000000000000000000000MM0000000000000MM00000000MMMMJ000000000000000000000000000000000000000MM0000000000000000000MM00000000000000000MMMMM0000000000000000000000000000000000000000WMMM0000000000000M0000MM0M0000000000000000000000000000000000000000000000000000000000000000000000000000000000000000000000000000000000000000000000000000000000000000000000000000000000000000000000000000000000000000000000000000000000000000000000000000000000000000000000000000000000000000000000000000000000000000000000000000000000000000000000000000000000000000000000000000000000000000000000000000000000000000000000000000000000000000000000000000000000000000000000000000000000000000000000000000000000000000000
M0MMMM00000000000000000000000M000000000000000000000000000000000000000000000000000000000000000000000000000000000000MMM00000000000000MM00000000000000000000000000WMMM0000000000000000XXX00000000000000MMMMMMMMMMMMMM0000000000000000000000000000000000000000000MM0000000000000000000000MMMMMMM00000000000000000000000000000000000000000000000000000000MM00000000MM00000000000000000000000000000000000000000000000000000000000000WM000000000000MM00000000000000000MMM0000MMM000000000000000000000000000000000000000000WMMM0000000000000MM0M0M0MM0000000000000000000000000000000000000000000000000000000000000000000000000000000000000000000000000000000000000000000000000000000000000000000000000000000000000000000000000000000000000000000000000000000000000000000000000000000000000000000000000000000000000000000000000000000000000000000000000000000000000000000000000000000000000000000000000000000000000000000000000000000000000000000000000000000000000000000000000000000000000000000000000000000000000000000000000000000000000000000
M000MM00000000000000000000000M00000000000000000000000000000000000000000000XX0000000000000000MMMM00000000000000000000000000000000000000000000MMM0000000000000000MMMM000000000000000000000000000000000MMMMMMM00000000000000000000000000000000000000000000000000000000000000000000MMM00000000000000000000000000000000000000000000000000000000000000000000000000000000000000000000000000000000000000000000000000000000000000000000MMM000000000MMMM000000000000000000000000000000000000000000000000000000000000000000000WMMM0000000000000M00M0M00M0000000000000000000000000000000000000000000000000000000000000000000000000000000000000000000000000000000000000000000000000000000000000000000000000000000000000000000000000000000000000000000000000000000000000000000000000000000000000000000000000000000000000000000000000000000000000000000000000000000000000000000000000000000000000000000000000000000000000000000000000000000000000000000000000000000000000000000000000000000000000000000000000000000000000000000000000000000000000000000
MMM0MM00000000000000000000000M000000000000000000000000000000000000000000000000000000000MMMMMMMMMMJJMMMM0000000000000000000000000000000000000MMM0000000000000000MMMM00000000000J000000000000000000000MMMMM000000000000000MMMMMMM000000000000000000000000MMM00000000M000000000MMMMMM00000000000000000000000000000000000000000000000000000000000000MM00000000000000000000000000000MM0000000000000000000000000000000000000000MMM00MMM0000000MMMMMM0000000000000000000000000000000000000000MMMMMMMMMMM000000000000000MMMMMMM0000000F00000M00M000000000000000000000000000000000000000000000000000000000000000000000000000000000000000000000000000000000000000000000000000000000000000000000000000000000000000000000000000000000000000000000000000000000000000000000000000000000000000000000000000000000000000000000000000000000000000000000000000000000000000000000000000000000000000000000000000000000000000000000000000000000000000000000000000000000000000000000000000000000000000000000000000000000000000000000000000000000000000000000000
M000MM00000000000000000000000M00000000000000000MMM000M000M00M0M0M00M000M0000000000MMMMMMMMMMMMMMMMMMMMMM000000000000000000000000000000000000MMM00000000000MM000MMMM00000000000M0000000000000MJJM000000000000MMMMM0000000MMMMMMM00XX0000000XX00000MMM00000000000000M000000MMMMMMMMMM000000000000000MMMMMMMM00000000000000000000000000000000000MMMMM00000000000000000000000000000MMM00000000000MMMMMM0000000000000000000000MMW00MMMMM000MMMMMMMM00000000MMMM000000000000000000000MMMMMMMMMMMMMMMMMM00000000MMM0000MMMMMMM00000MMMMM0000000000000000000000000000000000000000000000000000000000000000000000000000000000000000000000000000000000000000000000000000000000000000000000000000000000000000000000000000000000000000000000000000000000000000000000000000000000000000000000000000000000000000000000000000000000000000000000000000000000000000000000000000000000000000000000000000000000000000000000000000000000000000000000000000000000000000000000000000000000000000000000000000000000000000000000000000000000000000000000000000000
MMMMMMM0000000MMMMMMMM0000000M000000MM0000000MMMMM000M000M00M0M0M00M000M0000000MMMMMMMMMMMMMMMMMMMMMMMMMMM00000000000000000000000000000MMMJ0MMM0000000MM00MM000MMMM00000000000M0000000000000MMMM0000000000MMMMMMM0000000MMMMMMMM00000XXX000000000MMMM0000000000000M000MMMMMMMMMMMMM0000000000MMMMMMMMMMMMMMMMMMMMMJJMMMMJJMMMMJJMMMMJJMMMMMMMMMMMM00000000000000000000000000000MMMMMMMMMMMMMMMMMMMM00XX00XX000XX00XX00000MMM00MMMMMMMMMMMMMMMM00000MMMMMMM00JJ000000000000MMMMMMMMMMMMMMMMMMMMMMM00MMM0000000000MMMMMMM00000MMMMM0000000000000000000000000000000000000000000000000000000000000000000000000000000000000000000000000000000000000000000000000000000000000000000000000000000000000000000000000000000000000000000000000000000000000000000000000000000000000000000000000000000000000000000000000000000000000000000000000000000000000000000000000000000000000000000000000000000000000000000000000000000000000000000000000000000000000000000000000000000000000000000000000000000000000000000000000000000000000000000000000000000
MMMMMMMMMMMMMMMMMMMMMM000JJ00M00JJ00MM00MM000MMMMM000M000M00M0M0M00M000M0000000MMMMMMMMMMMMMMMMMMMMMMMMMMMMM000MMM0000MMMM0000MM000MMMMMMMM0MMM000MM00MM00MM000MMMM00000J00000M0000000000000MMMM0000MMMMMMMMMMMM0000J000MMMMMMMM00000000000000000MMMMM000000000000MMMMMMMMMMMMMMMMMMMMMMMMMMMMMMMMMMMMMMMMMMMMMMMMMMMMMMMMMMMMMMMMMMMMMMMMMMMMMMMM00000000000000000000000000000MMMMMMMMMMMMMMMMMMMM0000000000000000000000MMM00MMMMMMMMMMMMMMMM00000MMMMMMM00000MMM0000MMMMMMMMMMMMMMMMMMMMMMMMMMM000000000000000MMMMMMM00000MMMMM0000000000000000000000000000000000000000000000000000000000000000000000000000000000000000000000000000000000000000000000000000000000000000000000000000000000000000000000000000000000000000000000000000000000000000000000000000000000000000000000000000000000000000000000000000000000000000000000000000000000000000000000000000000000000000000000000000000000000000000000000000000000000000000000000000000000000000000000000000000000000000000000000000000000000000000000000000000000000000000000000000000
0000000000000000000000000000000000000000000000000000000000000000000000000000000000000000000000000000000000000000000000000000000000000000000000000000000000000000000000000000000000000000000000000000000000000000000000000000000000000000000000000000000000000000000000000000000000000000000000000000000000000000000000000000000000000000000000000000000000000000000000000000000000000000000000000000000000000000000000000000000000000000000000000000000000000000000000000000000000000000000000000000000000000000000000000000000000000000000000000000000000000000000000000000000000000000000000000000000000000000000000000000000000000000000000000000000000000000000000000000000000000000000000000000000000000000000000000000000000000000000000000000000000000000000000000000000000000000000000000000000000000000000000000000000000000000000000000000000000000000000000000000000000000000000000000000000000000000000000000000000000000000000000000000000000000000000000000000000000000000000000000000000000000000000000000000000000000000
